#########################
|                       |
|%%%|                   |
|                       |
|                       |
|                 |%%%%%|
|        |%%%%%|        |
|                       |
|%|              |%%|   |
|                       |
| |%|      |%%%|     |% | 
|                       |
#########################