#########################
|                       |
|%%%|   |%%%%%%%%%|     |
|                       |
|%%%%%%%%|     |%%%%%|  |
|                       |
|  |%%%%%%%%%%%%|   |%%%|
|                       |
|%%|  |%%%%%%%%%%%%%|   |
|                       |
|%%%%%%%%%%%%%%%%|   |%%|
|                       |
#########################